const short sewer_map_data_map[4900] = {
10, 10, 10, 10, 10, 10, 10, 10, 10, 10, 10, 10, 10, 10, 10, 10, 
10, 10, 10, 10, 10, 10, 10, 10, 10, 10, 10, 10, 10, 10, 10, 10, 
10, 10, 10, 10, 10, 10, 10, 10, 10, 10, 10, 10, 10, 10, 10, 10, 
10, 10, 10, 10, 10, 10, 10, 10, 10, 10, 10, 10, 10, 10, 10, 10, 
10, 10, 10, 10, 10, 10,
10, 10, 10, 10, 10, 10, 10, 10, 10, 10, 10, 10, 10, 10, 10, 10, 
10, 10, 10, 10, 10, 10, 10, 10, 10, 10, 10, 10, 10, 10, 10, 10, 
10, 10, 10, 10, 10, 10, 10, 10, 10, 10, 10, 10, 10, 10, 10, 10, 
10, 10, 10, 10, 10, 10, 10, 10, 10, 10, 10, 10, 10, 10, 10, 10, 
10, 10, 10, 10, 10, 10,
10, 10, 10, 10, 10, 10, 10, 10, 10, 10, 10, 10, 10, 10, 10, 10, 
10, 10, 10, 10, 10, 10, 10, 10, 10, 10, 10, 10, 10, 10, 10, 10, 
10, 10, 10, 10, 10, 10, 10, 10, 10, 10, 10, 10, 10, 10, 10, 10, 
10, 10, 10, 10, 10, 10, 10, 10, 10, 10, 10, 10, 10, 10, 10, 10, 
10, 10, 10, 10, 10, 10,
10, 10, 10, 10, 10, 10, 10, 10, 10, 10, 10, 10, 10, 10, 10, 10, 
10, 10, 10, 10, 10, 10, 10, 10, 10, 10, 10, 10, 10, 10, 10, 10, 
10, 10, 10, 10, 10, 10, 10, 10, 10, 10, 10, 10, 10, 10, 10, 10, 
10, 10, 10, 10, 10, 10, 10, 10, 10, 10, 10, 10, 10, 10, 10, 10, 
10, 10, 10, 10, 10, 10,
10, 10, 10, 10, 65, 2, 2, 2, 2, 2, 2, 3, 65, 2, 2, 2, 
2, 2, 2, 2, 2, 2, 2, 3, 65, 2, 2, 2, 2, 2, 2, 2, 
2, 2, 2, 2, 2, 2, 2, 2, 2, 2, 2, 2, 2, 2, 2, 2, 
2, 3, 10, 10, 10, 10, 10, 10, 10, 10, 65, 2, 2, 3, 10, 10, 
10, 10, 10, 10, 10, 10,
10, 10, 10, 10, 9, 50, 50, 50, 50, 50, 50, 11, 9, 50, 50, 50, 
50, 50, 50, 50, 50, 50, 50, 11, 9, 50, 51, 39, 40, 49, 51, 39, 
40, 49, 51, 39, 40, 49, 51, 39, 40, 49, 50, 50, 50, 50, 50, 50, 
50, 11, 10, 10, 10, 10, 10, 10, 10, 10, 9, 50, 50, 11, 10, 10, 
10, 10, 10, 10, 10, 10,
10, 10, 10, 10, 9, 50, 50, 50, 50, 50, 50, 11, 9, 50, 50, 50, 
50, 50, 50, 50, 50, 50, 50, 11, 9, 50, 51, 53, 53, 49, 51, 53, 
53, 49, 51, 53, 53, 49, 51, 53, 53, 49, 55, 58, 58, 56, 50, 50, 
50, 12, 2, 2, 2, 2, 2, 2, 2, 2, 13, 50, 50, 12, 2, 2, 
2, 3, 10, 10, 10, 10,
10, 10, 10, 10, 9, 50, 50, 4, 5, 50, 50, 11, 9, 50, 50, 4, 
5, 50, 50, 4, 5, 50, 50, 11, 9, 50, 51, 53, 53, 49, 51, 53, 
53, 49, 63, 42, 42, 64, 63, 42, 42, 64, 51, 39, 40, 4, 5, 50, 
50, 50, 50, 50, 50, 50, 50, 50, 50, 50, 50, 50, 50, 50, 50, 50, 
50, 11, 10, 10, 10, 10,
10, 10, 10, 10, 9, 50, 50, 11, 9, 50, 50, 12, 13, 50, 50, 11, 
9, 50, 50, 12, 13, 50, 50, 11, 9, 50, 51, 53, 53, 57, 59, 53, 
53, 49, 55, 58, 58, 58, 58, 58, 58, 58, 59, 53, 53, 12, 13, 50, 
50, 50, 50, 50, 50, 50, 50, 50, 50, 50, 50, 50, 50, 50, 50, 50, 
50, 11, 10, 10, 10, 10,
10, 10, 10, 10, 9, 50, 50, 11, 9, 50, 50, 50, 50, 50, 50, 11, 
9, 50, 50, 50, 50, 50, 50, 11, 9, 50, 51, 53, 53, 38, 38, 53, 
53, 49, 51, 31, 32, 38, 38, 31, 32, 38, 38, 53, 53, 49, 50, 50, 
50, 4, 18, 18, 18, 18, 18, 18, 18, 18, 5, 50, 50, 4, 5, 50, 
50, 11, 10, 10, 10, 10,
10, 10, 10, 10, 9, 50, 50, 12, 13, 50, 50, 50, 50, 50, 50, 11, 
9, 50, 50, 50, 50, 50, 50, 11, 9, 50, 51, 53, 53, 53, 53, 53, 
53, 49, 51, 53, 53, 53, 53, 53, 53, 53, 53, 53, 53, 49, 50, 50, 
50, 12, 2, 2, 2, 2, 2, 2, 2, 2, 13, 50, 50, 11, 9, 50, 
50, 11, 10, 10, 10, 10,
10, 10, 10, 10, 9, 50, 50, 50, 50, 4, 5, 50, 50, 4, 18, 19, 
17, 18, 18, 18, 18, 5, 50, 11, 9, 50, 63, 42, 42, 42, 43, 53, 
53, 49, 51, 53, 53, 41, 42, 42, 42, 42, 43, 53, 53, 49, 50, 4, 
5, 50, 50, 50, 50, 50, 50, 50, 50, 50, 50, 50, 50, 11, 9, 50, 
50, 11, 10, 10, 10, 10,
10, 10, 10, 10, 9, 50, 50, 50, 50, 11, 9, 50, 50, 11, 65, 2, 
2, 2, 2, 2, 3, 9, 50, 11, 9, 50, 55, 58, 58, 56, 51, 53, 
53, 49, 51, 53, 53, 49, 55, 58, 58, 58, 59, 53, 53, 49, 50, 11, 
9, 50, 50, 50, 50, 50, 50, 50, 50, 50, 50, 50, 50, 11, 9, 50, 
50, 11, 10, 10, 10, 10,
10, 10, 10, 10, 17, 18, 5, 50, 50, 11, 9, 50, 50, 11, 9, 55, 
56, 41, 42, 43, 11, 9, 50, 11, 9, 50, 51, 31, 32, 49, 51, 53, 
53, 49, 51, 53, 53, 49, 51, 31, 32, 38, 38, 53, 53, 4, 18, 19, 
17, 18, 18, 18, 18, 18, 18, 18, 18, 18, 5, 50, 50, 11, 17, 18, 
18, 19, 10, 10, 10, 10,
10, 10, 10, 10, 65, 2, 13, 50, 50, 11, 9, 50, 50, 12, 13, 63, 
64, 57, 58, 59, 11, 9, 50, 11, 9, 50, 51, 53, 53, 49, 51, 53, 
53, 49, 51, 53, 53, 49, 51, 53, 53, 53, 53, 53, 53, 12, 2, 2, 
2, 2, 2, 2, 2, 2, 2, 3, 10, 10, 9, 50, 50, 12, 2, 2, 
2, 3, 10, 10, 10, 10,
10, 10, 10, 10, 9, 50, 50, 50, 50, 11, 9, 55, 56, 55, 56, 55, 
56, 4, 18, 18, 19, 9, 50, 11, 9, 50, 51, 53, 53, 49, 63, 42, 
42, 64, 51, 53, 53, 49, 63, 42, 42, 42, 42, 42, 42, 64, 50, 50, 
50, 50, 50, 50, 50, 50, 50, 11, 10, 10, 9, 50, 50, 50, 50, 50, 
50, 11, 10, 10, 10, 10,
10, 10, 10, 10, 9, 50, 50, 50, 50, 11, 9, 63, 64, 63, 64, 63, 
64, 11, 65, 2, 2, 13, 58, 12, 13, 58, 59, 53, 53, 49, 55, 58, 
58, 58, 59, 53, 53, 49, 55, 58, 58, 58, 58, 58, 58, 56, 50, 50, 
50, 50, 50, 50, 50, 50, 50, 11, 10, 10, 9, 50, 50, 50, 50, 50, 
50, 11, 10, 10, 10, 10,
10, 10, 10, 10, 9, 50, 50, 4, 18, 19, 17, 18, 18, 18, 18, 18, 
18, 19, 9, 53, 53, 53, 50, 38, 38, 53, 53, 53, 53, 49, 51, 31, 
32, 38, 38, 53, 53, 49, 51, 31, 32, 38, 38, 31, 32, 4, 18, 18, 
18, 18, 18, 18, 5, 50, 50, 11, 10, 10, 9, 50, 50, 4, 5, 50, 
50, 11, 10, 10, 10, 10,
10, 10, 10, 10, 9, 50, 50, 11, 65, 2, 2, 2, 2, 2, 2, 2, 
2, 3, 9, 53, 53, 53, 50, 53, 53, 53, 53, 53, 53, 49, 51, 53, 
53, 53, 53, 53, 53, 49, 51, 53, 53, 53, 53, 53, 53, 12, 2, 2, 
2, 2, 2, 3, 9, 50, 50, 11, 10, 10, 9, 50, 50, 11, 9, 50, 
50, 11, 10, 10, 10, 10,
10, 10, 10, 10, 9, 50, 50, 11, 9, 50, 50, 50, 50, 50, 50, 50, 
50, 11, 9, 42, 42, 42, 42, 42, 42, 42, 43, 53, 53, 49, 51, 53, 
53, 41, 42, 42, 42, 50, 51, 53, 53, 41, 42, 42, 42, 64, 50, 50, 
50, 50, 50, 11, 9, 50, 50, 11, 10, 10, 9, 50, 50, 11, 9, 50, 
50, 11, 10, 10, 10, 10,
10, 10, 10, 10, 9, 50, 50, 11, 9, 50, 50, 50, 50, 50, 50, 50, 
50, 11, 9, 50, 50, 50, 50, 50, 50, 50, 51, 53, 53, 57, 59, 53, 
53, 49, 55, 58, 58, 58, 59, 53, 53, 49, 55, 58, 58, 56, 50, 50, 
50, 50, 50, 11, 9, 50, 50, 11, 65, 2, 13, 50, 50, 11, 9, 50, 
50, 11, 10, 10, 10, 10,
10, 10, 10, 10, 9, 50, 50, 11, 9, 50, 50, 4, 18, 18, 5, 41, 
43, 11, 17, 18, 18, 18, 18, 18, 5, 50, 51, 53, 53, 38, 38, 53, 
53, 49, 51, 31, 32, 38, 38, 53, 53, 49, 51, 31, 32, 4, 18, 18, 
5, 50, 50, 11, 9, 50, 50, 11, 9, 50, 50, 4, 18, 19, 9, 50, 
50, 11, 10, 10, 10, 10,
10, 10, 10, 10, 9, 50, 50, 12, 13, 50, 50, 12, 2, 3, 9, 57, 
59, 12, 2, 2, 2, 2, 2, 3, 9, 50, 51, 53, 53, 53, 53, 53, 
53, 49, 51, 53, 53, 53, 53, 53, 53, 49, 51, 53, 53, 12, 2, 3, 
9, 50, 50, 11, 9, 50, 50, 11, 9, 50, 50, 12, 2, 2, 13, 50, 
50, 11, 10, 10, 10, 10,
10, 10, 10, 10, 17, 18, 5, 50, 50, 50, 50, 50, 50, 11, 17, 18, 
5, 50, 50, 50, 50, 50, 50, 11, 9, 50, 51, 53, 53, 41, 42, 42, 
42, 64, 51, 53, 53, 41, 42, 42, 42, 64, 51, 53, 53, 49, 50, 11, 
9, 50, 50, 11, 9, 50, 50, 11, 9, 50, 50, 50, 50, 50, 50, 50, 
50, 11, 10, 10, 10, 10,
10, 10, 10, 10, 10, 10, 9, 50, 50, 50, 50, 50, 50, 12, 2, 2, 
13, 50, 50, 50, 50, 50, 50, 11, 9, 50, 51, 53, 53, 49, 55, 58, 
58, 58, 59, 53, 53, 49, 55, 58, 58, 56, 51, 53, 53, 49, 50, 11, 
9, 50, 50, 11, 9, 50, 50, 11, 9, 50, 50, 50, 50, 50, 50, 50, 
50, 11, 10, 10, 10, 10,
10, 10, 10, 10, 10, 10, 9, 50, 50, 4, 5, 50, 50, 50, 50, 50, 
50, 4, 18, 18, 5, 50, 50, 11, 9, 50, 51, 53, 53, 49, 51, 31, 
32, 38, 38, 53, 53, 49, 51, 31, 32, 49, 51, 53, 53, 49, 50, 11, 
9, 50, 50, 11, 9, 50, 50, 11, 9, 50, 50, 4, 5, 50, 50, 4, 
18, 19, 10, 10, 10, 10,
10, 10, 10, 10, 10, 10, 9, 50, 50, 11, 9, 50, 50, 50, 50, 50, 
50, 11, 65, 2, 13, 50, 50, 11, 9, 50, 51, 53, 53, 49, 51, 53, 
53, 53, 53, 53, 53, 49, 51, 53, 53, 49, 51, 53, 53, 49, 50, 11, 
9, 50, 50, 11, 9, 50, 50, 11, 9, 50, 50, 11, 9, 50, 50, 11, 
10, 10, 10, 10, 10, 10,
10, 10, 10, 10, 10, 10, 9, 50, 50, 11, 17, 18, 18, 18, 5, 50, 
50, 11, 9, 50, 50, 50, 50, 11, 9, 50, 63, 42, 42, 64, 51, 53, 
53, 41, 42, 42, 42, 64, 51, 53, 53, 49, 51, 53, 53, 49, 50, 11, 
9, 50, 50, 11, 9, 50, 50, 11, 9, 50, 50, 11, 9, 50, 50, 11, 
10, 10, 10, 10, 10, 10,
10, 10, 10, 10, 65, 2, 13, 50, 50, 11, 65, 2, 2, 3, 9, 50, 
50, 11, 9, 50, 50, 50, 50, 11, 9, 50, 55, 58, 58, 58, 59, 53, 
53, 57, 58, 58, 58, 58, 59, 53, 53, 49, 51, 53, 53, 49, 50, 11, 
9, 50, 50, 11, 9, 50, 50, 11, 9, 50, 50, 11, 9, 50, 50, 11, 
10, 10, 10, 10, 10, 10,
10, 10, 10, 10, 9, 50, 50, 4, 18, 19, 9, 50, 50, 11, 9, 50, 
50, 11, 9, 50, 50, 4, 18, 19, 17, 18, 5, 31, 32, 38, 38, 53, 
53, 38, 38, 31, 32, 38, 38, 53, 53, 49, 51, 53, 53, 49, 50, 11, 
9, 50, 50, 11, 9, 50, 50, 11, 9, 50, 50, 11, 9, 50, 50, 11, 
10, 10, 10, 10, 10, 10,
10, 10, 10, 10, 9, 50, 50, 12, 2, 2, 13, 50, 50, 11, 9, 50, 
50, 11, 9, 50, 50, 12, 2, 2, 2, 2, 13, 53, 53, 53, 53, 53, 
53, 53, 53, 53, 53, 53, 53, 53, 53, 49, 51, 53, 53, 49, 50, 12, 
13, 50, 50, 12, 13, 50, 50, 12, 13, 50, 50, 12, 13, 50, 50, 12, 
2, 3, 10, 10, 10, 10,
10, 10, 10, 10, 9, 50, 50, 50, 50, 50, 50, 50, 50, 11, 9, 50, 
50, 11, 9, 50, 50, 50, 50, 50, 50, 50, 51, 53, 53, 41, 42, 42, 
42, 42, 42, 42, 42, 42, 43, 53, 53, 49, 51, 53, 53, 49, 50, 50, 
50, 50, 50, 50, 50, 50, 50, 50, 50, 50, 50, 50, 50, 50, 50, 50, 
50, 11, 10, 10, 10, 10,
10, 10, 10, 10, 9, 50, 50, 50, 50, 50, 50, 50, 50, 12, 13, 50, 
50, 11, 9, 50, 50, 50, 50, 50, 50, 50, 51, 53, 53, 49, 55, 58, 
58, 58, 58, 58, 58, 56, 51, 53, 53, 49, 51, 53, 53, 49, 50, 50, 
50, 50, 50, 50, 50, 50, 50, 50, 50, 50, 50, 50, 50, 50, 50, 50, 
50, 11, 10, 10, 10, 10,
10, 10, 10, 10, 17, 18, 5, 50, 50, 4, 18, 18, 5, 50, 50, 50, 
50, 11, 9, 50, 50, 4, 18, 18, 5, 50, 51, 53, 53, 49, 51, 31, 
32, 38, 38, 31, 32, 49, 63, 42, 42, 64, 51, 53, 53, 4, 18, 18, 
18, 18, 5, 50, 50, 4, 5, 50, 50, 4, 5, 50, 50, 4, 5, 50, 
50, 11, 10, 10, 10, 10,
10, 10, 10, 10, 10, 10, 9, 50, 50, 11, 10, 10, 9, 50, 50, 50, 
50, 12, 13, 50, 50, 11, 10, 10, 9, 50, 51, 53, 53, 49, 51, 53, 
53, 53, 53, 53, 53, 57, 58, 58, 58, 56, 51, 53, 53, 12, 2, 2, 
2, 2, 13, 50, 50, 11, 9, 50, 50, 11, 9, 50, 50, 11, 9, 50, 
50, 11, 10, 10, 10, 10,
10, 10, 10, 10, 10, 10, 9, 50, 50, 11, 10, 10, 9, 50, 50, 4, 
5, 50, 50, 50, 50, 11, 10, 10, 9, 50, 51, 53, 53, 49, 63, 42, 
42, 42, 43, 53, 53, 38, 38, 31, 32, 49, 51, 53, 53, 49, 50, 50, 
50, 50, 50, 50, 50, 11, 9, 50, 50, 11, 9, 50, 50, 11, 9, 50, 
50, 11, 10, 10, 10, 10,
10, 10, 10, 10, 65, 2, 13, 50, 50, 12, 2, 3, 9, 50, 50, 11, 
9, 50, 50, 50, 50, 12, 2, 2, 13, 50, 51, 53, 53, 49, 55, 58, 
58, 56, 51, 53, 53, 53, 53, 53, 53, 49, 51, 53, 53, 49, 50, 50, 
50, 50, 50, 50, 50, 11, 9, 50, 50, 12, 13, 50, 50, 11, 9, 50, 
50, 11, 10, 10, 10, 10,
10, 10, 10, 10, 9, 50, 50, 50, 50, 50, 50, 11, 9, 50, 50, 11, 
9, 50, 50, 4, 5, 50, 50, 50, 50, 50, 51, 53, 53, 49, 51, 31, 
32, 49, 63, 42, 42, 42, 43, 53, 53, 49, 51, 53, 53, 49, 50, 4, 
5, 50, 50, 4, 18, 19, 17, 18, 5, 50, 50, 50, 50, 11, 9, 50, 
50, 11, 10, 10, 10, 10,
10, 10, 10, 10, 9, 50, 50, 50, 50, 50, 50, 12, 13, 50, 50, 12, 
13, 50, 50, 11, 9, 50, 50, 50, 50, 50, 51, 53, 53, 49, 51, 53, 
53, 57, 58, 58, 58, 56, 51, 53, 53, 49, 51, 53, 53, 49, 50, 11, 
9, 50, 50, 11, 65, 2, 2, 2, 13, 50, 50, 50, 50, 12, 13, 50, 
50, 11, 10, 10, 10, 10,
10, 10, 10, 10, 9, 50, 50, 4, 5, 50, 50, 50, 50, 50, 50, 50, 
50, 4, 18, 19, 9, 50, 50, 4, 5, 50, 63, 42, 42, 64, 51, 53, 
53, 38, 38, 31, 32, 49, 63, 42, 42, 64, 51, 53, 53, 49, 50, 11, 
9, 50, 50, 11, 9, 50, 50, 50, 50, 50, 50, 4, 5, 50, 50, 50, 
50, 11, 10, 10, 10, 10,
10, 10, 10, 10, 9, 50, 50, 11, 9, 50, 50, 50, 50, 50, 50, 50, 
50, 12, 2, 2, 13, 50, 50, 11, 9, 50, 55, 58, 58, 56, 51, 53, 
53, 53, 53, 53, 53, 49, 55, 58, 58, 56, 51, 53, 53, 49, 50, 11, 
9, 50, 50, 11, 9, 50, 50, 50, 50, 50, 50, 11, 9, 50, 50, 50, 
50, 11, 10, 10, 10, 10,
10, 10, 10, 10, 9, 50, 50, 11, 17, 18, 18, 18, 18, 18, 5, 50, 
50, 50, 50, 50, 50, 4, 18, 19, 9, 50, 51, 31, 32, 49, 51, 53, 
53, 41, 42, 42, 42, 64, 51, 31, 32, 49, 51, 53, 53, 49, 50, 11, 
9, 50, 50, 11, 17, 18, 18, 18, 18, 18, 18, 19, 9, 50, 50, 4, 
18, 19, 10, 10, 10, 10,
10, 10, 10, 10, 9, 50, 50, 12, 2, 2, 2, 2, 2, 3, 9, 50, 
50, 50, 50, 50, 50, 12, 2, 3, 9, 50, 51, 53, 53, 57, 59, 53, 
53, 49, 55, 58, 58, 56, 51, 53, 53, 49, 51, 53, 53, 49, 50, 12, 
13, 50, 50, 11, 65, 2, 2, 2, 2, 3, 65, 2, 13, 50, 50, 12, 
2, 3, 10, 10, 10, 10,
10, 10, 10, 10, 9, 50, 50, 50, 50, 50, 50, 50, 50, 11, 9, 50, 
50, 4, 5, 50, 50, 50, 50, 11, 9, 50, 51, 53, 53, 38, 38, 53, 
53, 49, 51, 31, 32, 49, 51, 53, 53, 49, 51, 53, 53, 4, 5, 50, 
50, 50, 50, 11, 9, 50, 50, 50, 50, 11, 9, 50, 50, 50, 50, 50, 
50, 11, 10, 10, 10, 10,
10, 10, 10, 10, 9, 50, 50, 50, 50, 50, 50, 50, 50, 12, 13, 50, 
50, 11, 9, 50, 50, 50, 50, 11, 9, 50, 51, 53, 53, 53, 53, 53, 
53, 49, 51, 53, 53, 57, 59, 53, 53, 49, 51, 53, 53, 12, 13, 50, 
50, 50, 50, 12, 13, 50, 50, 50, 50, 11, 9, 50, 50, 50, 50, 50, 
50, 11, 10, 10, 10, 10,
10, 10, 10, 10, 17, 18, 5, 50, 50, 4, 18, 18, 5, 50, 50, 4, 
18, 19, 17, 18, 5, 50, 50, 11, 9, 50, 63, 42, 42, 42, 42, 42, 
42, 64, 51, 53, 53, 38, 38, 53, 53, 49, 51, 53, 53, 49, 50, 50, 
50, 4, 5, 50, 50, 50, 50, 4, 18, 19, 9, 50, 50, 4, 5, 50, 
50, 11, 10, 10, 10, 10,
10, 10, 10, 10, 65, 2, 13, 50, 50, 12, 2, 3, 9, 50, 50, 12, 
2, 2, 2, 2, 13, 50, 50, 11, 9, 50, 55, 58, 58, 56, 55, 58, 
58, 56, 51, 53, 53, 53, 53, 53, 53, 49, 51, 53, 53, 49, 50, 50, 
50, 12, 13, 50, 50, 50, 50, 12, 2, 2, 13, 50, 50, 11, 9, 50, 
50, 11, 10, 10, 10, 10,
10, 10, 10, 10, 9, 50, 50, 50, 50, 50, 50, 11, 9, 50, 50, 50, 
50, 50, 50, 50, 50, 50, 50, 11, 17, 18, 5, 31, 32, 49, 51, 31, 
32, 49, 51, 53, 53, 41, 43, 53, 53, 49, 51, 53, 53, 49, 50, 4, 
5, 50, 50, 50, 50, 4, 5, 50, 50, 50, 50, 50, 50, 11, 17, 18, 
18, 19, 10, 10, 10, 10,
10, 10, 10, 10, 9, 50, 50, 50, 50, 50, 50, 11, 9, 50, 50, 50, 
50, 50, 50, 50, 50, 50, 50, 11, 65, 2, 13, 53, 53, 57, 59, 53, 
53, 49, 51, 53, 53, 49, 51, 53, 53, 49, 51, 53, 53, 49, 50, 11, 
9, 50, 50, 50, 50, 11, 9, 50, 50, 50, 50, 50, 50, 12, 2, 2, 
2, 3, 10, 10, 10, 10,
10, 10, 10, 10, 9, 50, 50, 4, 5, 50, 50, 11, 9, 50, 50, 4, 
18, 18, 18, 18, 5, 50, 50, 11, 9, 50, 51, 53, 53, 38, 38, 53, 
53, 49, 63, 42, 42, 64, 63, 42, 42, 64, 51, 53, 53, 49, 50, 11, 
9, 50, 50, 4, 18, 19, 17, 18, 5, 50, 50, 4, 5, 50, 50, 50, 
50, 11, 10, 10, 10, 10,
10, 10, 10, 10, 9, 50, 50, 11, 9, 50, 50, 12, 13, 50, 50, 11, 
65, 2, 2, 2, 13, 50, 50, 12, 13, 50, 51, 53, 53, 53, 53, 53, 
53, 57, 58, 58, 58, 58, 58, 58, 58, 56, 51, 53, 53, 49, 50, 11, 
9, 50, 50, 12, 2, 3, 65, 2, 13, 50, 50, 12, 13, 50, 50, 50, 
50, 11, 10, 10, 10, 10,
10, 10, 10, 10, 9, 50, 50, 11, 17, 18, 5, 50, 50, 50, 50, 11, 
9, 50, 50, 50, 50, 50, 50, 50, 50, 50, 63, 42, 42, 42, 43, 53, 
53, 38, 38, 31, 32, 38, 38, 31, 32, 49, 51, 53, 53, 49, 50, 11, 
9, 50, 50, 50, 50, 11, 9, 50, 50, 50, 50, 50, 50, 4, 5, 50, 
50, 11, 10, 10, 10, 10,
10, 10, 10, 10, 9, 50, 50, 11, 65, 2, 13, 50, 50, 50, 50, 11, 
9, 50, 50, 50, 50, 50, 50, 50, 50, 50, 55, 58, 58, 56, 51, 53, 
53, 53, 53, 53, 53, 53, 53, 53, 53, 49, 51, 53, 53, 49, 50, 11, 
9, 50, 50, 50, 50, 12, 13, 50, 50, 50, 50, 50, 50, 11, 9, 50, 
50, 11, 10, 10, 10, 10,
10, 10, 10, 10, 9, 50, 50, 11, 9, 50, 50, 4, 18, 18, 18, 19, 
9, 50, 50, 4, 5, 50, 50, 4, 18, 18, 5, 31, 32, 49, 51, 53, 
53, 41, 43, 53, 53, 41, 43, 53, 53, 49, 51, 53, 53, 4, 18, 19, 
17, 18, 5, 50, 50, 50, 50, 50, 50, 4, 5, 50, 50, 11, 9, 50, 
50, 11, 10, 10, 10, 10,
10, 10, 10, 10, 9, 50, 50, 12, 13, 50, 50, 11, 10, 10, 65, 2, 
13, 50, 50, 11, 9, 50, 50, 12, 2, 2, 13, 53, 53, 49, 51, 53, 
53, 49, 51, 53, 53, 49, 51, 53, 53, 49, 51, 53, 53, 12, 2, 2, 
2, 2, 13, 50, 50, 50, 50, 50, 50, 11, 9, 50, 50, 11, 9, 50, 
50, 11, 10, 10, 10, 10,
10, 10, 10, 10, 9, 50, 50, 50, 50, 50, 50, 11, 10, 10, 9, 50, 
50, 50, 50, 11, 9, 50, 50, 50, 50, 50, 51, 53, 53, 49, 51, 53, 
53, 49, 51, 53, 53, 49, 63, 42, 42, 64, 51, 53, 53, 49, 50, 50, 
50, 50, 50, 4, 18, 18, 5, 50, 50, 11, 9, 50, 50, 11, 9, 50, 
50, 11, 10, 10, 10, 10,
10, 10, 10, 10, 9, 50, 50, 50, 50, 50, 50, 11, 65, 2, 13, 50, 
50, 50, 50, 11, 9, 50, 50, 50, 50, 50, 51, 53, 53, 49, 51, 53, 
53, 49, 51, 53, 53, 49, 55, 58, 58, 56, 51, 53, 53, 49, 50, 50, 
50, 50, 50, 11, 10, 10, 9, 50, 50, 11, 9, 50, 50, 12, 13, 50, 
50, 11, 10, 10, 10, 10,
10, 10, 10, 10, 17, 18, 18, 18, 5, 50, 50, 11, 9, 50, 50, 4, 
5, 50, 50, 11, 17, 18, 18, 18, 5, 50, 51, 53, 53, 49, 63, 42, 
42, 64, 63, 42, 42, 64, 51, 31, 32, 49, 51, 53, 53, 4, 18, 18, 
5, 50, 50, 11, 10, 10, 9, 50, 50, 11, 9, 50, 50, 50, 50, 50, 
50, 11, 10, 10, 10, 10,
10, 10, 10, 10, 65, 2, 2, 2, 13, 50, 50, 11, 9, 50, 50, 11, 
9, 50, 50, 12, 2, 3, 10, 10, 9, 50, 51, 53, 53, 49, 55, 58, 
58, 58, 58, 58, 58, 58, 59, 53, 53, 49, 51, 53, 53, 12, 2, 2, 
13, 50, 50, 12, 2, 2, 13, 50, 50, 11, 9, 50, 50, 50, 50, 50, 
50, 11, 10, 10, 10, 10,
10, 10, 10, 10, 9, 50, 50, 50, 50, 50, 50, 11, 9, 50, 50, 11, 
9, 50, 50, 50, 50, 11, 10, 10, 9, 50, 51, 53, 53, 49, 51, 31, 
32, 38, 38, 31, 32, 38, 38, 53, 53, 49, 51, 53, 53, 49, 50, 50, 
50, 50, 50, 50, 50, 50, 50, 50, 50, 11, 17, 18, 5, 50, 50, 4, 
18, 19, 10, 10, 10, 10,
10, 10, 10, 10, 9, 50, 50, 50, 50, 50, 50, 12, 13, 50, 50, 11, 
9, 50, 50, 50, 50, 12, 2, 2, 13, 50, 51, 53, 53, 49, 51, 53, 
53, 53, 53, 53, 53, 53, 53, 53, 53, 49, 51, 53, 53, 49, 50, 50, 
50, 50, 50, 50, 50, 50, 50, 50, 50, 11, 65, 2, 13, 58, 58, 12, 
2, 3, 10, 10, 10, 10,
10, 10, 10, 10, 9, 50, 50, 4, 5, 50, 50, 50, 50, 50, 50, 11, 
17, 18, 18, 18, 5, 50, 50, 50, 50, 50, 51, 53, 53, 49, 51, 53, 
53, 41, 42, 42, 42, 42, 43, 53, 53, 49, 51, 53, 53, 4, 5, 50, 
50, 4, 18, 18, 18, 18, 18, 18, 18, 19, 9, 50, 51, 41, 43, 49, 
50, 11, 10, 10, 10, 10,
10, 10, 10, 10, 9, 50, 50, 12, 13, 50, 50, 50, 50, 50, 50, 12, 
2, 2, 2, 2, 13, 50, 50, 50, 50, 50, 51, 53, 53, 49, 51, 53, 
53, 49, 55, 58, 58, 56, 51, 53, 53, 49, 51, 53, 53, 12, 13, 50, 
50, 12, 2, 2, 2, 2, 2, 2, 2, 2, 13, 50, 51, 57, 59, 49, 
50, 11, 10, 10, 10, 10,
10, 10, 10, 10, 9, 50, 50, 50, 50, 4, 18, 18, 5, 50, 50, 50, 
50, 50, 50, 50, 50, 50, 50, 4, 5, 50, 51, 53, 53, 49, 51, 53, 
53, 49, 51, 31, 32, 49, 63, 42, 42, 64, 51, 53, 53, 49, 50, 50, 
50, 50, 50, 50, 50, 50, 50, 50, 50, 50, 50, 4, 5, 42, 42, 4, 
18, 19, 10, 10, 10, 10,
10, 10, 10, 10, 9, 50, 50, 50, 50, 11, 10, 10, 9, 50, 50, 50, 
50, 50, 50, 50, 50, 50, 50, 11, 9, 50, 51, 53, 53, 49, 51, 53, 
53, 49, 51, 53, 53, 49, 50, 50, 50, 50, 51, 53, 53, 49, 50, 50, 
50, 50, 50, 50, 50, 50, 50, 50, 50, 50, 50, 11, 9, 50, 50, 11, 
10, 10, 10, 10, 10, 10,
10, 10, 10, 10, 17, 18, 18, 18, 18, 19, 10, 10, 17, 18, 18, 18, 
18, 18, 18, 18, 18, 18, 18, 19, 17, 18, 18, 18, 18, 18, 18, 18, 
18, 18, 18, 18, 18, 18, 18, 18, 18, 18, 18, 18, 18, 18, 18, 18, 
18, 18, 18, 18, 18, 18, 18, 18, 18, 18, 18, 19, 17, 18, 18, 19, 
10, 10, 10, 10, 10, 10,
10, 10, 10, 10, 10, 10, 10, 10, 10, 10, 10, 10, 10, 10, 10, 10, 
10, 10, 10, 10, 10, 10, 10, 10, 10, 10, 10, 10, 10, 10, 10, 10, 
10, 10, 10, 10, 10, 10, 10, 10, 10, 10, 10, 10, 10, 10, 10, 10, 
10, 10, 10, 10, 10, 10, 10, 10, 10, 10, 10, 10, 10, 10, 10, 10, 
10, 10, 10, 10, 10, 10,
10, 10, 10, 10, 10, 10, 10, 10, 10, 10, 10, 10, 10, 10, 10, 10, 
10, 10, 10, 10, 10, 10, 10, 10, 10, 10, 10, 10, 10, 10, 10, 10, 
10, 10, 10, 10, 10, 10, 10, 10, 10, 10, 10, 10, 10, 10, 10, 10, 
10, 10, 10, 10, 10, 10, 10, 10, 10, 10, 10, 10, 10, 10, 10, 10, 
10, 10, 10, 10, 10, 10,
10, 10, 10, 10, 10, 10, 10, 10, 10, 10, 10, 10, 10, 10, 10, 10, 
10, 10, 10, 10, 10, 10, 10, 10, 10, 10, 10, 10, 10, 10, 10, 10, 
10, 10, 10, 10, 10, 10, 10, 10, 10, 10, 10, 10, 10, 10, 10, 10, 
10, 10, 10, 10, 10, 10, 10, 10, 10, 10, 10, 10, 10, 10, 10, 10, 
10, 10, 10, 10, 10, 10,
10, 10, 10, 10, 10, 10, 10, 10, 10, 10, 10, 10, 10, 10, 10, 10, 
10, 10, 10, 10, 10, 10, 10, 10, 10, 10, 10, 10, 10, 10, 10, 10, 
10, 10, 10, 10, 10, 10, 10, 10, 10, 10, 10, 10, 10, 10, 10, 10, 
10, 10, 10, 10, 10, 10, 10, 10, 10, 10, 10, 10, 10, 10, 10, 10, 
10, 10, 10, 10, 10, 10
};

