const short sewer_map_data_map[4900] = {
10, 10, 10, 10, 10, 10, 10, 10, 10, 10, 10, 10, 10, 10, 10, 10, 
10, 10, 10, 10, 10, 10, 10, 10, 10, 10, 10, 10, 10, 10, 10, 10, 
10, 10, 10, 10, 10, 10, 10, 10, 10, 10, 10, 10, 10, 10, 10, 10, 
10, 10, 10, 10, 10, 10, 10, 10, 10, 10, 10, 10, 10, 10, 10, 10, 
10, 10, 10, 10, 10, 10,
10, 10, 10, 10, 10, 10, 10, 10, 10, 10, 10, 10, 10, 10, 10, 10, 
10, 10, 10, 10, 10, 10, 10, 10, 10, 10, 10, 10, 10, 10, 10, 10, 
10, 10, 10, 10, 10, 10, 10, 10, 10, 10, 10, 10, 10, 10, 10, 10, 
10, 10, 10, 10, 10, 10, 10, 10, 10, 10, 10, 10, 10, 10, 10, 10, 
10, 10, 10, 10, 10, 10,
10, 10, 10, 10, 10, 10, 10, 10, 10, 10, 10, 10, 10, 10, 10, 10, 
10, 10, 10, 10, 10, 10, 10, 10, 10, 10, 10, 10, 10, 10, 10, 10, 
10, 10, 10, 10, 10, 10, 10, 10, 10, 10, 10, 10, 10, 10, 10, 10, 
10, 10, 10, 10, 10, 10, 10, 10, 10, 10, 10, 10, 10, 10, 10, 10, 
10, 10, 10, 10, 10, 10,
10, 10, 10, 10, 10, 10, 10, 10, 10, 10, 10, 10, 10, 10, 10, 10, 
10, 10, 10, 10, 10, 10, 10, 10, 10, 10, 10, 10, 10, 10, 10, 10, 
10, 10, 10, 10, 10, 10, 10, 10, 10, 10, 10, 10, 10, 10, 10, 10, 
10, 10, 10, 10, 10, 10, 10, 10, 10, 10, 10, 10, 10, 10, 10, 10, 
10, 10, 10, 10, 10, 10,
10, 10, 10, 10, 29, 2, 2, 2, 2, 2, 2, 3, 29, 2, 2, 2, 
2, 2, 2, 2, 2, 2, 2, 3, 29, 2, 2, 2, 2, 2, 2, 2, 
2, 2, 2, 2, 2, 2, 2, 2, 2, 2, 2, 2, 2, 2, 2, 2, 
2, 3, 10, 10, 10, 10, 10, 10, 10, 10, 29, 2, 2, 3, 10, 10, 
10, 10, 10, 10, 10, 10,
10, 10, 10, 10, 9, 50, 50, 50, 50, 50, 50, 11, 9, 50, 50, 50, 
50, 50, 50, 50, 50, 50, 50, 11, 9, 50, 50, 39, 40, 50, 50, 39, 
40, 50, 50, 39, 40, 50, 50, 39, 40, 50, 50, 50, 50, 50, 50, 50, 
50, 11, 10, 10, 10, 10, 10, 10, 10, 10, 9, 50, 50, 11, 10, 10, 
10, 10, 10, 10, 10, 10,
10, 10, 10, 10, 9, 50, 50, 50, 50, 50, 50, 11, 9, 50, 50, 50, 
50, 50, 50, 50, 50, 50, 50, 11, 9, 50, 50, 27, 27, 50, 50, 27, 
27, 50, 50, 27, 27, 50, 50, 27, 27, 50, 50, 50, 50, 50, 50, 50, 
50, 12, 2, 2, 2, 2, 2, 2, 2, 2, 13, 50, 50, 12, 2, 2, 
2, 3, 10, 10, 10, 10,
10, 10, 10, 10, 9, 50, 50, 4, 5, 50, 50, 11, 9, 50, 50, 4, 
5, 50, 50, 4, 5, 50, 50, 11, 9, 50, 50, 27, 27, 50, 50, 27, 
27, 50, 50, 50, 50, 50, 50, 50, 50, 50, 50, 39, 40, 4, 5, 50, 
50, 50, 50, 50, 50, 50, 50, 50, 50, 50, 50, 50, 50, 50, 50, 50, 
50, 11, 10, 10, 10, 10,
10, 10, 10, 10, 9, 50, 50, 11, 9, 50, 50, 12, 13, 50, 50, 11, 
9, 50, 50, 12, 13, 50, 50, 11, 9, 50, 50, 27, 27, 50, 50, 27, 
27, 50, 50, 50, 50, 50, 50, 50, 50, 50, 50, 27, 27, 12, 13, 50, 
50, 50, 50, 50, 50, 50, 50, 50, 50, 50, 50, 50, 50, 50, 50, 50, 
50, 11, 10, 10, 10, 10,
10, 10, 10, 10, 9, 50, 50, 11, 9, 50, 50, 50, 50, 50, 50, 11, 
9, 50, 50, 50, 50, 50, 50, 11, 9, 50, 50, 27, 27, 38, 38, 27, 
27, 50, 50, 31, 32, 38, 38, 31, 32, 38, 38, 27, 27, 50, 50, 50, 
50, 4, 18, 18, 18, 18, 18, 18, 18, 18, 5, 50, 50, 4, 5, 50, 
50, 11, 10, 10, 10, 10,
10, 10, 10, 10, 9, 50, 50, 12, 13, 50, 50, 50, 50, 50, 50, 11, 
9, 50, 50, 50, 50, 50, 50, 11, 9, 50, 50, 27, 27, 27, 27, 27, 
27, 50, 50, 27, 27, 27, 27, 27, 27, 27, 27, 27, 27, 50, 50, 50, 
50, 12, 2, 2, 2, 2, 2, 2, 2, 2, 13, 50, 50, 11, 9, 50, 
50, 11, 10, 10, 10, 10,
10, 10, 10, 10, 9, 50, 50, 50, 50, 4, 5, 50, 50, 4, 18, 19, 
17, 18, 18, 18, 18, 5, 50, 11, 9, 50, 50, 50, 50, 50, 50, 27, 
27, 50, 50, 27, 27, 50, 50, 50, 50, 50, 50, 27, 27, 50, 50, 4, 
5, 50, 50, 50, 50, 50, 50, 50, 50, 50, 50, 50, 50, 11, 9, 50, 
50, 11, 10, 10, 10, 10,
10, 10, 10, 10, 9, 50, 50, 50, 50, 11, 9, 50, 50, 11, 29, 2, 
2, 2, 2, 2, 3, 9, 50, 11, 9, 50, 50, 50, 50, 50, 50, 27, 
27, 50, 50, 27, 27, 50, 50, 50, 50, 50, 50, 27, 27, 50, 50, 11, 
9, 50, 50, 50, 50, 50, 50, 50, 50, 50, 50, 50, 50, 11, 9, 50, 
50, 11, 10, 10, 10, 10,
10, 10, 10, 10, 17, 18, 5, 50, 50, 11, 9, 50, 50, 11, 9, 50, 
50, 50, 50, 50, 11, 9, 50, 11, 9, 50, 50, 31, 32, 50, 50, 27, 
27, 50, 50, 27, 27, 50, 50, 31, 32, 38, 38, 27, 27, 4, 18, 19, 
17, 18, 18, 18, 18, 18, 18, 18, 18, 18, 5, 50, 50, 11, 17, 18, 
18, 19, 10, 10, 10, 10,
10, 10, 10, 10, 29, 2, 13, 50, 50, 11, 9, 50, 50, 12, 13, 50, 
50, 50, 50, 50, 11, 9, 50, 11, 9, 50, 50, 27, 27, 50, 50, 27, 
27, 50, 50, 27, 27, 50, 50, 27, 27, 27, 27, 27, 27, 12, 2, 2, 
2, 2, 2, 2, 2, 2, 2, 3, 10, 10, 9, 50, 50, 12, 2, 2, 
2, 3, 10, 10, 10, 10,
10, 10, 10, 10, 9, 50, 50, 50, 50, 11, 9, 50, 50, 50, 50, 50, 
50, 4, 18, 18, 19, 9, 50, 11, 9, 50, 50, 27, 27, 50, 50, 50, 
50, 50, 50, 27, 27, 50, 50, 50, 50, 50, 50, 50, 50, 50, 50, 50, 
50, 50, 50, 50, 50, 50, 50, 11, 10, 10, 9, 50, 50, 50, 50, 50, 
50, 11, 10, 10, 10, 10,
10, 10, 10, 10, 9, 50, 50, 50, 50, 11, 9, 50, 50, 50, 50, 50, 
50, 11, 29, 2, 2, 13, 50, 12, 13, 50, 50, 27, 27, 50, 50, 50, 
50, 50, 50, 27, 27, 50, 50, 50, 50, 50, 50, 50, 50, 50, 50, 50, 
50, 50, 50, 50, 50, 50, 50, 11, 10, 10, 9, 50, 50, 50, 50, 50, 
50, 11, 10, 10, 10, 10,
10, 10, 10, 10, 9, 50, 50, 4, 18, 19, 17, 18, 18, 18, 18, 18, 
18, 19, 9, 38, 38, 38, 50, 38, 38, 38, 38, 27, 27, 50, 50, 31, 
32, 38, 38, 27, 27, 50, 50, 31, 32, 38, 38, 31, 32, 4, 18, 18, 
18, 18, 18, 18, 5, 50, 50, 11, 10, 10, 9, 50, 50, 4, 5, 50, 
50, 11, 10, 10, 10, 10,
10, 10, 10, 10, 9, 50, 50, 11, 29, 2, 2, 2, 2, 2, 2, 2, 
2, 3, 9, 27, 27, 27, 50, 27, 27, 27, 27, 27, 27, 50, 50, 27, 
27, 27, 27, 27, 27, 50, 50, 27, 27, 27, 27, 27, 27, 12, 2, 2, 
2, 2, 2, 3, 9, 50, 50, 11, 10, 10, 9, 50, 50, 11, 9, 50, 
50, 11, 10, 10, 10, 10,
10, 10, 10, 10, 9, 50, 50, 11, 9, 50, 50, 50, 50, 50, 50, 50, 
50, 11, 9, 50, 50, 50, 50, 50, 50, 50, 50, 27, 27, 50, 50, 27, 
27, 50, 50, 50, 50, 50, 50, 27, 27, 50, 50, 50, 50, 50, 50, 50, 
50, 50, 50, 11, 9, 50, 50, 11, 10, 10, 9, 50, 50, 11, 9, 50, 
50, 11, 10, 10, 10, 10,
10, 10, 10, 10, 9, 50, 50, 11, 9, 50, 50, 50, 50, 50, 50, 50, 
50, 11, 9, 50, 50, 50, 50, 50, 50, 50, 50, 27, 27, 50, 50, 27, 
27, 50, 50, 50, 50, 50, 50, 27, 27, 50, 50, 50, 50, 50, 50, 50, 
50, 50, 50, 11, 9, 50, 50, 11, 29, 2, 13, 50, 50, 11, 9, 50, 
50, 11, 10, 10, 10, 10,
10, 10, 10, 10, 9, 50, 50, 11, 9, 50, 50, 4, 18, 18, 5, 50, 
50, 11, 17, 18, 18, 18, 18, 18, 5, 50, 50, 27, 27, 38, 38, 27, 
27, 50, 50, 31, 32, 38, 38, 27, 27, 50, 50, 31, 32, 4, 18, 18, 
5, 50, 50, 11, 9, 50, 50, 11, 9, 50, 50, 4, 18, 19, 9, 50, 
50, 11, 10, 10, 10, 10,
10, 10, 10, 10, 9, 50, 50, 12, 13, 50, 50, 12, 2, 3, 9, 50, 
50, 12, 2, 2, 2, 2, 2, 3, 9, 50, 50, 27, 27, 27, 27, 27, 
27, 50, 50, 27, 27, 27, 27, 27, 27, 50, 50, 27, 27, 12, 2, 3, 
9, 50, 50, 11, 9, 50, 50, 11, 9, 50, 50, 12, 2, 2, 13, 50, 
50, 11, 10, 10, 10, 10,
10, 10, 10, 10, 17, 18, 5, 50, 50, 50, 50, 50, 50, 11, 17, 18, 
5, 50, 50, 50, 50, 50, 50, 11, 9, 50, 50, 27, 27, 50, 50, 50, 
50, 50, 50, 27, 27, 50, 50, 50, 50, 50, 50, 27, 27, 50, 50, 11, 
9, 50, 50, 11, 9, 50, 50, 11, 9, 50, 50, 50, 50, 50, 50, 50, 
50, 11, 10, 10, 10, 10,
10, 10, 10, 10, 10, 10, 9, 50, 50, 50, 50, 50, 50, 12, 2, 2, 
13, 50, 50, 50, 50, 50, 50, 11, 9, 50, 50, 27, 27, 50, 50, 50, 
50, 50, 50, 27, 27, 50, 50, 50, 50, 50, 50, 27, 27, 50, 50, 11, 
9, 50, 50, 11, 9, 50, 50, 11, 9, 50, 50, 50, 50, 50, 50, 50, 
50, 11, 10, 10, 10, 10,
10, 10, 10, 10, 10, 10, 9, 50, 50, 4, 5, 50, 50, 50, 50, 50, 
50, 4, 18, 18, 5, 50, 50, 11, 9, 50, 50, 27, 27, 50, 50, 31, 
32, 38, 38, 27, 27, 50, 50, 31, 32, 50, 50, 27, 27, 50, 50, 11, 
9, 50, 50, 11, 9, 50, 50, 11, 9, 50, 50, 4, 5, 50, 50, 4, 
18, 19, 10, 10, 10, 10,
10, 10, 10, 10, 10, 10, 9, 50, 50, 11, 9, 50, 50, 50, 50, 50, 
50, 11, 29, 2, 13, 50, 50, 11, 9, 50, 50, 27, 27, 50, 50, 27, 
27, 27, 27, 27, 27, 50, 50, 27, 27, 50, 50, 27, 27, 50, 50, 11, 
9, 50, 50, 11, 9, 50, 50, 11, 9, 50, 50, 11, 9, 50, 50, 11, 
10, 10, 10, 10, 10, 10,
10, 10, 10, 10, 10, 10, 9, 50, 50, 11, 17, 18, 18, 18, 5, 50, 
50, 11, 9, 50, 50, 50, 50, 11, 9, 50, 50, 50, 50, 50, 50, 27, 
27, 50, 50, 50, 50, 50, 50, 27, 27, 50, 50, 27, 27, 50, 50, 11, 
9, 50, 50, 11, 9, 50, 50, 11, 9, 50, 50, 11, 9, 50, 50, 11, 
10, 10, 10, 10, 10, 10,
10, 10, 10, 10, 29, 2, 13, 50, 50, 11, 29, 2, 2, 3, 9, 50, 
50, 11, 9, 50, 50, 50, 50, 11, 9, 50, 50, 50, 50, 50, 50, 27, 
27, 50, 50, 50, 50, 50, 50, 27, 27, 50, 50, 27, 27, 50, 50, 11, 
9, 50, 50, 11, 9, 50, 50, 11, 9, 50, 50, 11, 9, 50, 50, 11, 
10, 10, 10, 10, 10, 10,
10, 10, 10, 10, 9, 50, 50, 4, 18, 19, 9, 50, 50, 11, 9, 50, 
50, 11, 9, 50, 50, 4, 18, 19, 17, 18, 5, 31, 32, 38, 38, 27, 
27, 38, 38, 31, 32, 38, 38, 27, 27, 50, 50, 27, 27, 50, 50, 11, 
9, 50, 50, 11, 9, 50, 50, 11, 9, 50, 50, 11, 9, 50, 50, 11, 
10, 10, 10, 10, 10, 10,
10, 10, 10, 10, 9, 50, 50, 12, 2, 2, 13, 50, 50, 11, 9, 50, 
50, 11, 9, 50, 50, 12, 2, 2, 2, 2, 13, 27, 27, 27, 27, 27, 
27, 27, 27, 27, 27, 27, 27, 27, 27, 50, 50, 27, 27, 50, 50, 12, 
13, 50, 50, 12, 13, 50, 50, 12, 13, 50, 50, 12, 13, 50, 50, 12, 
2, 3, 10, 10, 10, 10,
10, 10, 10, 10, 9, 50, 50, 50, 50, 50, 50, 50, 50, 11, 9, 50, 
50, 11, 9, 50, 50, 50, 50, 50, 50, 50, 50, 27, 27, 50, 50, 50, 
50, 50, 50, 50, 50, 50, 50, 27, 27, 50, 50, 27, 27, 50, 50, 50, 
50, 50, 50, 50, 50, 50, 50, 50, 50, 50, 50, 50, 50, 50, 50, 50, 
50, 11, 10, 10, 10, 10,
10, 10, 10, 10, 9, 50, 50, 50, 50, 50, 50, 50, 50, 12, 13, 50, 
50, 11, 9, 50, 50, 50, 50, 50, 50, 50, 50, 27, 27, 50, 50, 50, 
50, 50, 50, 50, 50, 50, 50, 27, 27, 50, 50, 27, 27, 50, 50, 50, 
50, 50, 50, 50, 50, 50, 50, 50, 50, 50, 50, 50, 50, 50, 50, 50, 
50, 11, 10, 10, 10, 10,
10, 10, 10, 10, 17, 18, 5, 50, 50, 4, 18, 18, 5, 50, 50, 50, 
50, 11, 9, 50, 50, 4, 18, 18, 5, 50, 50, 27, 27, 50, 50, 31, 
32, 38, 38, 31, 32, 50, 50, 50, 50, 50, 50, 27, 27, 4, 18, 18, 
18, 18, 5, 50, 50, 4, 5, 50, 50, 4, 5, 50, 50, 4, 5, 50, 
50, 11, 10, 10, 10, 10,
10, 10, 10, 10, 10, 10, 9, 50, 50, 11, 10, 10, 9, 50, 50, 50, 
50, 12, 13, 50, 50, 11, 10, 10, 9, 50, 50, 27, 27, 50, 50, 27, 
27, 27, 27, 27, 27, 50, 50, 50, 50, 50, 50, 27, 27, 12, 2, 2, 
2, 2, 13, 50, 50, 11, 9, 50, 50, 11, 9, 50, 50, 11, 9, 50, 
50, 11, 10, 10, 10, 10,
10, 10, 10, 10, 10, 10, 9, 50, 50, 11, 10, 10, 9, 50, 50, 4, 
5, 50, 50, 50, 50, 11, 10, 10, 9, 50, 50, 27, 27, 50, 50, 50, 
50, 50, 50, 27, 27, 38, 38, 31, 32, 50, 50, 27, 27, 50, 50, 50, 
50, 50, 50, 50, 50, 11, 9, 50, 50, 11, 9, 50, 50, 11, 9, 50, 
50, 11, 10, 10, 10, 10,
10, 10, 10, 10, 29, 2, 13, 50, 50, 12, 2, 3, 9, 50, 50, 11, 
9, 50, 50, 50, 50, 12, 2, 2, 13, 50, 50, 27, 27, 50, 50, 50, 
50, 50, 50, 27, 27, 27, 27, 27, 27, 50, 50, 27, 27, 50, 50, 50, 
50, 50, 50, 50, 50, 11, 9, 50, 50, 12, 13, 50, 50, 11, 9, 50, 
50, 11, 10, 10, 10, 10,
10, 10, 10, 10, 9, 50, 50, 50, 50, 50, 50, 11, 9, 50, 50, 11, 
9, 50, 50, 4, 5, 50, 50, 50, 50, 50, 50, 27, 27, 50, 50, 31, 
32, 50, 50, 50, 50, 50, 50, 27, 27, 50, 50, 27, 27, 50, 50, 4, 
5, 50, 50, 4, 18, 19, 17, 18, 5, 50, 50, 50, 50, 11, 9, 50, 
50, 11, 10, 10, 10, 10,
10, 10, 10, 10, 9, 50, 50, 50, 50, 50, 50, 12, 13, 50, 50, 12, 
13, 50, 50, 11, 9, 50, 50, 50, 50, 50, 50, 27, 27, 50, 50, 27, 
27, 50, 50, 50, 50, 50, 50, 27, 27, 50, 50, 27, 27, 50, 50, 11, 
9, 50, 50, 11, 29, 2, 2, 2, 13, 50, 50, 50, 50, 12, 13, 50, 
50, 11, 10, 10, 10, 10,
10, 10, 10, 10, 9, 50, 50, 4, 5, 50, 50, 50, 50, 50, 50, 50, 
50, 4, 18, 19, 9, 50, 50, 4, 5, 50, 50, 50, 50, 50, 50, 27, 
27, 38, 38, 31, 32, 50, 50, 50, 50, 50, 50, 27, 27, 50, 50, 11, 
9, 50, 50, 11, 9, 50, 50, 50, 50, 50, 50, 4, 5, 50, 50, 50, 
50, 11, 10, 10, 10, 10,
10, 10, 10, 10, 9, 50, 50, 11, 9, 50, 50, 50, 50, 50, 50, 50, 
50, 12, 2, 2, 13, 50, 50, 11, 9, 50, 50, 50, 50, 50, 50, 27, 
27, 27, 27, 27, 27, 50, 50, 50, 50, 50, 50, 27, 27, 50, 50, 11, 
9, 50, 50, 11, 9, 50, 50, 50, 50, 50, 50, 11, 9, 50, 50, 50, 
50, 11, 10, 10, 10, 10,
10, 10, 10, 10, 9, 50, 50, 11, 17, 18, 18, 18, 18, 18, 5, 50, 
50, 50, 50, 50, 50, 4, 18, 19, 9, 50, 50, 31, 32, 50, 50, 27, 
27, 50, 50, 50, 50, 50, 50, 31, 32, 50, 50, 27, 27, 50, 50, 11, 
9, 50, 50, 11, 17, 18, 18, 18, 18, 18, 18, 19, 9, 50, 50, 4, 
18, 19, 10, 10, 10, 10,
10, 10, 10, 10, 9, 50, 50, 12, 2, 2, 2, 2, 2, 3, 9, 50, 
50, 50, 50, 50, 50, 12, 2, 3, 9, 50, 50, 27, 27, 50, 50, 27, 
27, 50, 50, 50, 50, 50, 50, 27, 27, 50, 50, 27, 27, 50, 50, 12, 
13, 50, 50, 11, 29, 2, 2, 2, 2, 3, 29, 2, 13, 50, 50, 12, 
2, 3, 10, 10, 10, 10,
10, 10, 10, 10, 9, 50, 50, 50, 50, 50, 50, 50, 50, 11, 9, 50, 
50, 4, 5, 50, 50, 50, 50, 11, 9, 50, 50, 27, 27, 38, 38, 27, 
27, 50, 50, 31, 32, 50, 50, 27, 27, 50, 50, 27, 27, 4, 5, 50, 
50, 50, 50, 11, 9, 50, 50, 50, 50, 11, 9, 50, 50, 50, 50, 50, 
50, 11, 10, 10, 10, 10,
10, 10, 10, 10, 9, 50, 50, 50, 50, 50, 50, 50, 50, 12, 13, 50, 
50, 11, 9, 50, 50, 50, 50, 11, 9, 50, 50, 27, 27, 27, 27, 27, 
27, 50, 50, 27, 27, 50, 50, 27, 27, 50, 50, 27, 27, 12, 13, 50, 
50, 50, 50, 12, 13, 50, 50, 50, 50, 11, 9, 50, 50, 50, 50, 50, 
50, 11, 10, 10, 10, 10,
10, 10, 10, 10, 17, 18, 5, 50, 50, 4, 18, 18, 5, 50, 50, 4, 
18, 19, 17, 18, 5, 50, 50, 11, 9, 50, 50, 50, 50, 50, 50, 50, 
50, 50, 50, 27, 27, 38, 38, 27, 27, 50, 50, 27, 27, 50, 50, 50, 
50, 4, 5, 50, 50, 50, 50, 4, 18, 19, 9, 50, 50, 4, 5, 50, 
50, 11, 10, 10, 10, 10,
10, 10, 10, 10, 29, 2, 13, 50, 50, 12, 2, 3, 9, 50, 50, 12, 
2, 2, 2, 2, 13, 50, 50, 11, 9, 50, 50, 50, 50, 50, 50, 50, 
50, 50, 50, 27, 27, 27, 27, 27, 27, 50, 50, 27, 27, 50, 50, 50, 
50, 12, 13, 50, 50, 50, 50, 12, 2, 2, 13, 50, 50, 11, 9, 50, 
50, 11, 10, 10, 10, 10,
10, 10, 10, 10, 9, 50, 50, 50, 50, 50, 50, 11, 9, 50, 50, 50, 
50, 50, 50, 50, 50, 50, 50, 11, 17, 18, 5, 31, 32, 50, 50, 31, 
32, 50, 50, 27, 27, 50, 50, 27, 27, 50, 50, 27, 27, 50, 50, 4, 
5, 50, 50, 50, 50, 4, 5, 50, 50, 50, 50, 50, 50, 11, 17, 18, 
18, 19, 10, 10, 10, 10,
10, 10, 10, 10, 9, 50, 50, 50, 50, 50, 50, 11, 9, 50, 50, 50, 
50, 50, 50, 50, 50, 50, 50, 11, 29, 2, 13, 27, 27, 50, 50, 27, 
27, 50, 50, 27, 27, 50, 50, 27, 27, 50, 50, 27, 27, 50, 50, 11, 
9, 50, 50, 50, 50, 11, 9, 50, 50, 50, 50, 50, 50, 12, 2, 2, 
2, 3, 10, 10, 10, 10,
10, 10, 10, 10, 9, 50, 50, 4, 5, 50, 50, 11, 9, 50, 50, 4, 
18, 18, 18, 18, 5, 50, 50, 11, 9, 50, 50, 27, 27, 38, 38, 27, 
27, 50, 50, 50, 50, 50, 50, 50, 50, 50, 50, 27, 27, 50, 50, 11, 
9, 50, 50, 4, 18, 19, 17, 18, 5, 50, 50, 4, 5, 50, 50, 50, 
50, 11, 10, 10, 10, 10,
10, 10, 10, 10, 9, 50, 50, 11, 9, 50, 50, 12, 13, 50, 50, 11, 
29, 2, 2, 2, 13, 50, 50, 12, 13, 50, 50, 27, 27, 27, 27, 27, 
27, 50, 50, 50, 50, 50, 50, 50, 50, 50, 50, 27, 27, 50, 50, 11, 
9, 50, 50, 12, 2, 3, 29, 2, 13, 50, 50, 12, 13, 50, 50, 50, 
50, 11, 10, 10, 10, 10,
10, 10, 10, 10, 9, 50, 50, 11, 17, 18, 5, 50, 50, 50, 50, 11, 
9, 50, 50, 50, 50, 50, 50, 50, 50, 50, 50, 50, 50, 50, 50, 27, 
27, 38, 38, 31, 32, 38, 38, 31, 32, 50, 50, 27, 27, 50, 50, 11, 
9, 50, 50, 50, 50, 11, 9, 50, 50, 50, 50, 50, 50, 4, 5, 50, 
50, 11, 10, 10, 10, 10,
10, 10, 10, 10, 9, 50, 50, 11, 29, 2, 13, 50, 50, 50, 50, 11, 
9, 50, 50, 50, 50, 50, 50, 50, 50, 50, 50, 50, 50, 50, 50, 27, 
27, 27, 27, 27, 27, 27, 27, 27, 27, 50, 50, 27, 27, 50, 50, 11, 
9, 50, 50, 50, 50, 12, 13, 50, 50, 50, 50, 50, 50, 11, 9, 50, 
50, 11, 10, 10, 10, 10,
10, 10, 10, 10, 9, 50, 50, 11, 9, 50, 50, 4, 18, 18, 18, 19, 
9, 50, 50, 4, 5, 50, 50, 4, 18, 18, 5, 31, 32, 50, 50, 27, 
27, 50, 50, 27, 27, 50, 50, 27, 27, 50, 50, 27, 27, 4, 18, 19, 
17, 18, 5, 50, 50, 50, 50, 50, 50, 4, 5, 50, 50, 11, 9, 50, 
50, 11, 10, 10, 10, 10,
10, 10, 10, 10, 9, 50, 50, 12, 13, 50, 50, 11, 10, 10, 29, 2, 
13, 50, 50, 11, 9, 50, 50, 12, 2, 2, 13, 27, 27, 50, 50, 27, 
27, 50, 50, 27, 27, 50, 50, 27, 27, 50, 50, 27, 27, 12, 2, 2, 
2, 2, 13, 50, 50, 50, 50, 50, 50, 11, 9, 50, 50, 11, 9, 50, 
50, 11, 10, 10, 10, 10,
10, 10, 10, 10, 9, 50, 50, 50, 50, 50, 50, 11, 10, 10, 9, 50, 
50, 50, 50, 11, 9, 50, 50, 50, 50, 50, 50, 27, 27, 50, 50, 27, 
27, 50, 50, 27, 27, 50, 50, 50, 50, 50, 50, 27, 27, 50, 50, 50, 
50, 50, 50, 4, 18, 18, 5, 50, 50, 11, 9, 50, 50, 11, 9, 50, 
50, 11, 10, 10, 10, 10,
10, 10, 10, 10, 9, 50, 50, 50, 50, 50, 50, 11, 29, 2, 13, 50, 
50, 50, 50, 11, 9, 50, 50, 50, 50, 50, 50, 27, 27, 50, 50, 27, 
27, 50, 50, 27, 27, 50, 50, 50, 50, 50, 50, 27, 27, 50, 50, 50, 
50, 50, 50, 11, 10, 10, 9, 50, 50, 11, 9, 50, 50, 12, 13, 50, 
50, 11, 10, 10, 10, 10,
10, 10, 10, 10, 17, 18, 18, 18, 5, 50, 50, 11, 9, 50, 50, 4, 
5, 50, 50, 11, 17, 18, 18, 18, 5, 50, 50, 27, 27, 50, 50, 50, 
50, 50, 50, 50, 50, 50, 50, 31, 32, 50, 50, 27, 27, 4, 18, 18, 
5, 50, 50, 11, 10, 10, 9, 50, 50, 11, 9, 50, 50, 50, 50, 50, 
50, 11, 10, 10, 10, 10,
10, 10, 10, 10, 29, 2, 2, 2, 13, 50, 50, 11, 9, 50, 50, 11, 
9, 50, 50, 12, 2, 3, 10, 10, 9, 50, 50, 27, 27, 50, 50, 50, 
50, 50, 50, 50, 50, 50, 50, 27, 27, 50, 50, 27, 27, 12, 2, 2, 
13, 50, 50, 12, 2, 2, 13, 50, 50, 11, 9, 50, 50, 50, 50, 50, 
50, 11, 10, 10, 10, 10,
10, 10, 10, 10, 9, 50, 50, 50, 50, 50, 50, 11, 9, 50, 50, 11, 
9, 50, 50, 50, 50, 11, 10, 10, 9, 50, 50, 27, 27, 50, 50, 31, 
32, 38, 38, 31, 32, 38, 38, 27, 27, 50, 50, 27, 27, 50, 50, 50, 
50, 50, 50, 50, 50, 50, 50, 50, 50, 11, 17, 18, 5, 50, 50, 4, 
18, 19, 10, 10, 10, 10,
10, 10, 10, 10, 9, 50, 50, 50, 50, 50, 50, 12, 13, 50, 50, 11, 
9, 50, 50, 50, 50, 12, 2, 2, 13, 50, 50, 27, 27, 50, 50, 27, 
27, 27, 27, 27, 27, 27, 27, 27, 27, 50, 50, 27, 27, 50, 50, 50, 
50, 50, 50, 50, 50, 50, 50, 50, 50, 11, 29, 2, 13, 50, 50, 12, 
2, 3, 10, 10, 10, 10,
10, 10, 10, 10, 9, 50, 50, 4, 5, 50, 50, 50, 50, 50, 50, 11, 
17, 18, 18, 18, 5, 50, 50, 50, 50, 50, 50, 27, 27, 50, 50, 27, 
27, 50, 50, 50, 50, 50, 50, 27, 27, 50, 50, 27, 27, 4, 5, 50, 
50, 4, 18, 18, 18, 18, 18, 18, 18, 19, 9, 50, 50, 50, 50, 50, 
50, 11, 10, 10, 10, 10,
10, 10, 10, 10, 9, 50, 50, 12, 13, 50, 50, 50, 50, 50, 50, 12, 
2, 2, 2, 2, 13, 50, 50, 50, 50, 50, 50, 27, 27, 50, 50, 27, 
27, 50, 50, 50, 50, 50, 50, 27, 27, 50, 50, 27, 27, 12, 13, 50, 
50, 12, 2, 2, 2, 2, 2, 2, 2, 2, 13, 50, 50, 50, 50, 50, 
50, 11, 10, 10, 10, 10,
10, 10, 10, 10, 9, 50, 50, 50, 50, 4, 18, 18, 5, 50, 50, 50, 
50, 50, 50, 50, 50, 50, 50, 4, 5, 50, 50, 27, 27, 50, 50, 27, 
27, 50, 50, 31, 32, 50, 50, 50, 50, 50, 50, 27, 27, 50, 50, 50, 
50, 50, 50, 50, 50, 50, 50, 50, 50, 50, 50, 4, 5, 50, 50, 4, 
18, 19, 10, 10, 10, 10,
10, 10, 10, 10, 9, 50, 50, 50, 50, 11, 10, 10, 9, 50, 50, 50, 
50, 50, 50, 50, 50, 50, 50, 11, 9, 50, 50, 27, 27, 50, 50, 27, 
27, 50, 50, 27, 27, 50, 50, 50, 50, 50, 50, 27, 27, 50, 50, 50, 
50, 50, 50, 50, 50, 50, 50, 50, 50, 50, 50, 11, 9, 50, 50, 11, 
10, 10, 10, 10, 10, 10,
10, 10, 10, 10, 17, 18, 18, 18, 18, 19, 10, 10, 17, 18, 18, 18, 
18, 18, 18, 18, 18, 18, 18, 19, 17, 18, 18, 18, 18, 18, 18, 18, 
18, 18, 18, 18, 18, 18, 18, 18, 18, 18, 18, 18, 18, 18, 18, 18, 
18, 18, 18, 18, 18, 18, 18, 18, 18, 18, 18, 19, 17, 18, 18, 19, 
10, 10, 10, 10, 10, 10,
10, 10, 10, 10, 10, 10, 10, 10, 10, 10, 10, 10, 10, 10, 10, 10, 
10, 10, 10, 10, 10, 10, 10, 10, 10, 10, 10, 10, 10, 10, 10, 10, 
10, 10, 10, 10, 10, 10, 10, 10, 10, 10, 10, 10, 10, 10, 10, 10, 
10, 10, 10, 10, 10, 10, 10, 10, 10, 10, 10, 10, 10, 10, 10, 10, 
10, 10, 10, 10, 10, 10,
10, 10, 10, 10, 10, 10, 10, 10, 10, 10, 10, 10, 10, 10, 10, 10, 
10, 10, 10, 10, 10, 10, 10, 10, 10, 10, 10, 10, 10, 10, 10, 10, 
10, 10, 10, 10, 10, 10, 10, 10, 10, 10, 10, 10, 10, 10, 10, 10, 
10, 10, 10, 10, 10, 10, 10, 10, 10, 10, 10, 10, 10, 10, 10, 10, 
10, 10, 10, 10, 10, 10,
10, 10, 10, 10, 10, 10, 10, 10, 10, 10, 10, 10, 10, 10, 10, 10, 
10, 10, 10, 10, 10, 10, 10, 10, 10, 10, 10, 10, 10, 10, 10, 10, 
10, 10, 10, 10, 10, 10, 10, 10, 10, 10, 10, 10, 10, 10, 10, 10, 
10, 10, 10, 10, 10, 10, 10, 10, 10, 10, 10, 10, 10, 10, 10, 10, 
10, 10, 10, 10, 10, 10,
10, 10, 10, 10, 10, 10, 10, 10, 10, 10, 10, 10, 10, 10, 10, 10, 
10, 10, 10, 10, 10, 10, 10, 10, 10, 10, 10, 10, 10, 10, 10, 10, 
10, 10, 10, 10, 10, 10, 10, 10, 10, 10, 10, 10, 10, 10, 10, 10, 
10, 10, 10, 10, 10, 10, 10, 10, 10, 10, 10, 10, 10, 10, 10, 10, 
10, 10, 10, 10, 10, 10
};

